000002020000000000000000000000000000000000000000000000000000000000000000000
000002020000000000000000000000000000000000000000000000000000000000000000000
000002020000000000000000000000000000000000000000000000000000000000000000000
000002020000000000000000000000000000000000000000000000000000000000000000000
000002020000000000000000000000000000000000000000000000000000000000000000000
000002020000000000000000000000000000000000000000000000000000000000000000000
000002020000000000000000000000000000000000000000000000000000000000000000000
005002020000000000000000000000000000000000000000000000000000000000000000000
111112020000000000000000000000000000000000000000000000000000000000000000000
999962929999999000000000000000000000000000000000000000000000000000000000000
977992929999999000000000000000000000000000000000000000000000000000000000000
999992929999999000000000000000000000000000000000000000000000000000000000000
977992929999999000000000000000000000000000000000000000000000000000000000000
999999999999999000000000000000000000000000000000000000000000000000000000000
111111111111111111111111111111111111111111111111111111111111111100000000000
000000000000000000000000000000000020200000000000000000000000000000000000000
000000000000000000000000000000000020200000000000000000000000000000000000000
000000000000000000000000000000000020200000000000000000000000000000000000000
000000000000000000000000000000000020200000000000000000000000000000000000000
000000000000000000000000000000000020200000000000000000000000000000000000000
000000000000000000000000000000000020200000000000000000000000000000000000000
000000000000000000000000000000000020200000000000000000000000000000000000000
000000000000000000000000000000000020200000000000000000000000000000000000000
000000000011111111111111111111111121211111111111111111111111111111111111111
000000000000000000000000000000000020200000000000000000000000000000000000000
000000000000000000000000000000000020200000000000000000000000000000000000000
000000000000000000000000000000000020200000000000000000000000000000000000000
000000000000000000000000000000000020200000000000000000000000000000000000000
000000000000000000000000000000000020200000000000000000000000000000000000000
000000000000000000000000000000000020200000000000000000000000000000000000000
000000000000000000000000000000000020200000000000000000000000000000000000000
000000000000000000000000000000000020200000000000000000000000000000000000000
000000000000000000000000000000000020200000000000000000000000000000000000000
000000000000000000000000000000000020200000000000000000000000000000000000000
000000000000000000000000000000000020200000000000000000000000000000000000000
111111111111111111111111111111111121211111111111111111111111111111111100000
000000000000000000000000000000000020200000000000000000000000000000000000000
000000000000000000000000000000000020200000000000000000000000000000000000000
000000000000000000000000000000000020200000000000000000000000000000000000000
000000000000000000000000000000000020200000000000000000000000000000000000000
000000000000000000000000000000000020200000000000000000000000000000000000000
000000000000000000000000000000000020200000000000000000000000000000000000000
000000000000000000000000000000000020200000000000000000000000000000000000000
000000000000000000000000000000000020200000000000000000000000000000000000000
000000000000000000000000000000000020200000000000000000000000000000000000000
000000000000000000000000000000000020200000000000000000000000000000000000000
000000111111111111111111111111111121211111111111111111111111111111111111111
000000000000000000000000000000000020200000000000000000000000000000000000000
000000000000000000000000000000000020200000000000000000000000000000000000000
000000000000000000000000000000000020200000000000000000000000000000000000000
000000000000000000000000000000000020200000000000000000000000000000000000000
000000000000000000000000000000000020200000000000000000000000000000000000000
000000000000000000000000000000000020200000000000000000000000000000000000000
000000000000000000000000000000000020200000000000000000000000000000000000000
000000000000000000000000000000000020200000000000000000000000000000000000000
000000000000000000000000000000000020200000000000000000000000000000000000000
000000000000000000000000000000000020200000000000000000000000000000000000000
111111111111111111111111111111111121211111111111111111111111111111111000000
000000000000000000000000000000000020200000000000000000000000000000000000000
000000000000000000000000000000000020200000000000000000000000000000000000000
000000000000000000000000000000000020200000000000000000000000000000000000000
000000000000000000000000000000000020200000000000000000000000000000000000000
000000000000000000000000000000000020200000000000000000000000000000000000000
000000000000000000000000000000000020200000000000000000000000000000000000000
000000000000000000000000000000000020200000000000000000000000000000000000000
000000000000000000000000000000000020200000000000000000000000000000000000000
000000000000000000000000000000000020200000000000000000000000000000000000000
000000000000000000000000000000000020200000000000000000000000000000000000000
000000000000000000000000000000000020200000000000000000000000000000000000000
000000000000000000000000000000000020200000000000000000000000000000000000000
000111111111111111111111111111111121211111111111111111111111111111111111111
000000000000000000000000000000000020200000000000000000000000000000000000000
000000000000000000000000000000000020200000000000000000000000000000000000000
000000000000000000000000000000000020200000000000000000000000000000000000000
000000000000000000000000000000000020200000000000000000000000000000000000000