000000000000000000000000000000000000000000000000000000000000000000000000000
000000000000000000000000000000111111111111111000000000000000000000000000000
000000000000000000000000000000100000000000001000000000000000000000000000000
000000000000000000000000000000100000000000001000000000000000000000000000000
000000000000000000000000000000100000500000001000000000000000000000000000000
000000000000000000000000000000111111111111111000000000000000000000000000000
000000000000000000000000000000000000202000000000000000000000000000000000000
000000000000000000000000000000977969292997799000000000000000000000000000000
000000000000000000000000000000999999292999999000000000000000000000000000000
000000000000000000000000000000989999292998999000000000000000000000000000000
000000000000011100000000000000999799292979999000000000000011100000000000000
000000000000000000000000000000999999999999999000000000000000000000000000000
000000000000000000001111111111111111111111111111111111100000000000000000000
000000001110000000000000000000200000000000000200000000000000000011100000000
000000000020000000000000000000200000000000000200000000000000000020000000000
000000000020000000000000000000000000000000000000000000000000000020000000000
000000000000000000000000000000000000000000000000000000000000000000000000000
000000000000000000000000000000000000000000000000000000000000000000000000000
000000000000000000000000000000000000000000000000000000000000000000000000000
000000000000000011100000000000000000000000000000000000001110000000000000000
030000000000000000200000000000000000000000000000000000002000000000000000030
000000000000000000200000000000000000000000000000000000002000000000000000000
000000000000000000200000000000000000000000000000000000002000000000000000000
111111111000000000000000000000000000000000000000000000000000000000111111111
000000000000000000000000111111111111111111111111111000000000000000000000000
000000000000000000000000000000000000020000000000000000000000000000000000000
000000000000000000000000000000000000020000000000000000000000000000000000000
000000000000000000000000000000000000020000000000000000000000000000000000000
000000000000000000000000000000000000000000000000000000000000000000000000000
000000000000000000000000000000000000000000000000000000000000000000000000000
000000000000000000000000000000000000000000000000000000000000000000000000000
000000000000000001111111111111111111111111111111111111111100000000000000000
030000000000011111002000000000200000000000002000000000200111110000000000030
000000000000000000000000000000200000030000002000000000000000000000000000000
000000000000000000000000000000200000000000002000000000000000000000000000000
000000000000000000000000000000000000000000000000000000000000000000000000000
111111110000000000000000000001111111111111111100000000000000000000011111111
020000000000000000000000000000000000020000000000000000000000000000000000020
020000000000000000000000000000000000020000000000000000000000000000000000020
020000000001111110000000000000000000020000000000000000000011111100000000020
020000000000000000000000000000000000020000000000000000000000000000000000020
020000000000000000000000000000000000020000000000000000000000000000000000020
000000000000000000011111100000000000020000000000001111110000000000000000000
000000000000000000000000000000000000020000000000000000000000000000000000000
000000111111000000000000000000000000020000000000000000000000000111111000000
000000000000000000000000001111111111111111111111100000000000000000000000000
000000000000000000000000000020000000000000000020000000000000000000000000000
000000000000000000000000000020000000000000000020000000000000000000000000000
000000000000000000000000000020300000000000003020000000000000000000000000000
111110000000000000000000000000000000000000000000000000000000000000000011111
000011111110000000000000000000000000000000000000000000000000000011111110000
000000000011111110000000000000000000000000000000000000000011111110000000000
000000000000000011111110000000000000000000000000000011111110000000000000000
000000000000000000000000000000000000000000000000000000000000000000000000000
000000000000000000000000000000000000000000000000000000000000000000000000000
000000000000000000000000000000000000000000000000000000000000000000000000000
000000000000000000000000011111111111111111111111110000000000000000000000000
000000000000011111111111110000000000000000000000011111111111110000000000000
000000000000000000000000000000000000000000000000000000000000000000000000000
000000000000000000000000000000000000000000000000000000000000000000000000000
111111110000000000000000000000000000000000000000000000000000000000011111111
000000000000000000000000000000000000000000000000000000000000000000000000000
000000000000000000000000000000000000030000000000000000000000000000000000000
000000000000000000000000000000000000000000000000000000000000000000000000000
111111111111111110000001111111111111111111111111111100000011111111111111111
000000000000000000000000020000000000000000000000020000000000000000000000000
000000000000000000000000020000000000000000000000020000000000000000000000000
000000000000000000000000020000000000000000000000020000000000000000000000000
000000000000000000000000020000000000000000000000020000000000000000000000000
000000000000000000000000020000000000000000000000020000000000000000000000000
000000000000000000000000020000000000000000000000020000000000000000000000000
000000000000000000000000020000000000000000000000020000000000000000000000000
000000000000000000011000000011111111111111111110000000110000000000000000000
000000000000000000000000000000000000020000000000000000000000000000000000000
000000000000000000000000000000000000020000000000000000000000000000000000000