000002020000000000000000000000000000000000000000000000000000000000000000000
000002020000000000000000000000000000000000000000000000000000000000000000000
000002020000000000000000000000000000000000000000000000000000000000000000000
000002020000000000000000000000000000000000000000000000000000000000000000000
000002020000000000000000000000000000000000000000000000000000000000000000000
000002020000000000000000000000000000000000000000000000000000000000000000000
000002020000000000000000000000000000000000000000000000000000000000000000000
005002020000000000000000000000000000000000000000000000000000000000000000000
111112020000000000000000000000000000000000000000000000000000000000000000000
999962929999999000000000000000000000000000000000000000000000000000000000000
977992929999999000000000000000000000000000000000000000000000000000000000000
999992929999999000000000000000000000000000000000000000000000000000000000000
977992929999999000000000000000000000000000000000000000000000000000000000000
999999999999999000000000000000000000000000000000000000000000000000000000000
111111111111111000000000000000000000000000000000000000000000000000000000000
000000000000001111111111110000000000000000000000000000000000000000000000000
000000000000000000002000011111111111100000000000000000000000000000000000000
000000000000000000002000000000002000111111111111000000000000000000000000000
000000000000000000002000000000002000000000000001111111111110000000000000000
000000000000000000002000000000000000000000000000000002000011111100000000000
000000000000000000002000000000000000000000000000000002000000000000000000000
000000000000000000002000000000000000000000000000000002000000000000000000000
000000000000000000000000000000000000000000000000000002000000000000000000000
000000000000000000000000000000002000000000000000000002000000000001111111111
000000000000000000000000000000002000000000000000000002001111111111000000000
000000000000000000000000000000002000000000000000011111111000000000000000000
000000000000000000002000000000002000000001111111110000000000000000000000000
000000000000000000002000000000002001111111000000000000000000000000000000000
000000000000000000002000000000111111000200000000000000000000000000000000000
000000000000000000002000011111100000000230000000000000000000000000000000000
000000000000000111111111110000000000000200000000000000000000000000000000000
000000000011111102000000000000000000000200000000000000000000000000000000000
300000000000000002000000000000000000000200000000000000000000000000000000000
000000000000000002000000000000000000000000000000000000000000000000000000000
000000000000000002000000000000000000000000000000000000000000000000000000000
111111111000000002000000000000000000000000000000000000000000000000000000000
000000001111111002000000000000000000000000000000000000000000000000000000000
000000000000001111111111100000000000000000000000000000000000000000000000000
000000000000000000000000111111111100000000000000000000000000000000000000000
000000000000000000000000002000000111111111110000000000000000000000000000000
000000000000000000000000002000000000000000011111111111000000000000000000000
000000000000000000000000002000300000000000000002000001111111111100000000000
000000000000000000000000002000000000000000000000000000000000000111111100030
000000000000000000000000002000000000000000000000000000000000000000000000000
000000000000000000000000002000000000000000000000000000000000000000000000000
000000000000000000000000002000000000000000000000000000000000000000000000000
000000000000000000000000000000000000000000000002000000000000000011111111111
000000000000000000000000000000000000000000000002000000011111111110000000000
000000000000000000000000000000000000000000000001111111110000000000000000000
000000000000000000000000000000000000001111111111000000000000000000000000000
000000000000000000000000000001111111111000000000000000000000000000000000000
000000000000000000001111111111000000000000000000000000000000000000000000000
000000000001111111111000000200000000000000000000000000000000000000000000000
000000111111020000000000000200000000000000000000000000000000000000000000000
000000000000020000000000000200000000000000000000000000000000000000000000000
000000000000020000000000000200000000000000000000000000000000000000000000000
000000000000020000000000000200000000000000000000000000000000000000000000000
111111110000020000000000000200000000000000000000000000000000000000000000000
000000011111111000000000000200000000000000000000000000000000000000000000000
000000000000001111111110000200000000000000000000000000000000000000000000000
000000000000000000000011111110000000000000000000000000000000000000000000000
000000000000000000000000000011111111000000000000000000000000000000030000000
000000000000000000000000000000000001111111110000000000000000000000000000000
000000000000000000000000000000000000000000011111111100000000000000000000000
000000000000000000000000000000000000000000000200000111111110000000000000000
000000000000000000000000000000000000000000000200000000000011111110000000000
000000000000000000000000000000000000000000000200000000000000020011111000000
000000000000000000000000000000000000000000000200000000000000020000000000000
000000000000000000000000000000000000000000000200000000000000020000000000000
000000000000000000000000000000000000000000000200000000000000020000000000000
000000000000000000000000000000000000000011111111111111111111111111111111111
000000000000000000000001111111111111111110000000000000000000000000000000000
000111111111111111111111000000000000000000000000000000000000000000000000000
000000000002000000000000000000000000000000000000000000000000000000000000000
000000000002000000000000000000000000000000000000000000000000000000000000000