000002020000000000000000000000000000000000000000000000000000000000000000000
000002020000000000000000000000000000000000000000000000000000000000000000000
000002020000000000000000000000000000000000000000000000000000000000000000000
000002020000000000000000000000000000000000000000000000000000000000000000000
000002020000000000000000000000000000000000000000000000000000000000000000000
000002020000000000000000000000000000000000000000000000000000000000000000000
000002020000000000000000000000000000000000000000000000000000000000000000000
005002020000000000000000000000000000000000000000000000000000000000000000000
111112020000000000000000000000000000000000000000000000000000000000000000000
999962929999999000000000000000000000000000000000000000000000000000000000000
977992929999999000000000000000000000000000000000000000000000000000000000000
999992929999999000000000000000000000000000000000000000000000000000000000000
977992929999999000000000000000000000000000000000000000000000000000000000000
999999999999999000000000000000000000000000000000000000000000000000000000000
111111111111111000000000000000000000000000000000000000000000000000000000000
000000000000001111111111110000000000000000000000000000000000000000000000000
000000000000000000000000011111111111100000000000000000000000000000000000000
000000000000000000000000000000000000111111111111000000000000000000000000000
00000000000000000000000000000000*000000000000001111111111110000000000000000
000000000000000000000000000000000000000000000000000000000011111100000000000
000000000000000000000000000000000000000000000000000000000000000000000000000
00000000000000000000*000000000000000000000000000000000000000000000000000000
000000000000000000000000000000000000000000000000000000000000000000000000000
00000000000000000000000000000000#000000000000000000000000000000001111111111
00000000000000000000000000000000000000000000000000000*001111111111000000000
000000000000000000000000000000000000000000000000011111111000000000000000000
00000000000000000000#000000000000000000001111111110000000000000000000000000
000000000000000000000000000000000001111111000000000000000000000000000000000
000000000000000000000000000000111111000000000000000000000000000000000000000
000000000000000000000000011111100000000000000000000000000000000000000000000
000000000000000111111111110000000000000000000000000000000000000000000000000
000000000011111100000000000000000000000000000000000000000000000000000000000
000000000000000000000000000000000000000*00000000000000000000000000000000000
000000000000000000000000000000000000000000000000000000000000000000000000000
000000000000000000000000000000000000000000000000000000000000000000000000000
111111111000000000000000000000000000000000000000000000000000000000000000000
00000000111111100*000000000000000000000000000000000000000000000000000000000
000000000000001111111111100000000000000000000000000000000000000000000000000
000000000000000000000000111111111100000000000000000000000000000000000000000
000000000000000000000000000000000111111111110000000000000000000000000000000
000000000000000000000000000000000000000000011111111111000000000000000000000
00000000000000000000000000000000000000000000000*000001111111111100000000000
000000000000000000000000000000000000000000000000000000000000000111111100000
000000000000000000000000000000000000000000000000000000000000000000000000000
000000000000000000000000000000000000000000000000000000000000000000000000000
00000000000000000000000000*000000000000000000000000000000000000000000000000
00000000000000000000000000000000000000000000000#000000000000000011111111111
000000000000000000000000000000000000000000000000000000011111111110000000000
000000000000000000000000000000000000000000000001111111110000000000000000000
000000000000000000000000000000000000001111111111000000000000000000000000000
000000000000000000000000000001111111111000000000000000000000000000000000000
000000000000000000001111111111000000000000000000000000000000000000000000000
000000000001111111111000000000000000000000000000000000000000000000000000000
000000111111000000000000000000000000000000000000000000000000000000000000000
000000000000000000000000000000000000000000000000000000000000000000000000000
000000000000000000000000000000000000000000000000000000000000000000000000000
000000000000000000000000000000000000000000000000000000000000000000000000000
1111111100000*0000000000000000000000000000000000000000000000000000000000000
000000011111111000000000000000000000000000000000000000000000000000000000000
000000000000001111111110000*00000000000000000000000000000000000000000000000
000000000000000000000011111110000000000000000000000000000000000000000000000
000000000000000000000000000011111111000000000000000000000000000000000000000
000000000000000000000000000000000001111111110000000000000000000000000000000
000000000000000000000000000000000000000000011111111100000000000000000000000
000000000000000000000000000000000000000000000000000111111110000000000000000
000000000000000000000000000000000000000000000000000000000011111110000000000
000000000000000000000000000000000000000000000000000000000000000011111000000
000000000000000000000000000000000000000000000000000000000000000000000000000
000000000000000000000000000000000000000000000000000000000000000000000000000
000000000000000000000000000000000000000000000*000000000000000*0000000000000
000000000000000000000000000000000000000011111111111111111111111111111111111
000000000000000000000001111111111111111110000000000000000000000000000000000
000111111111111111111111000000000000000000000000000000000000000000000000000
000000000000000000000000000000000000000000000000000000000000000000000000000
00000000000*000000000000000000000000000000000000000000000000000000000000000