000000000000000000000000000000000002020000000000000000000000000000000000000
000000000000000000000000000000000002020000000000000000000000000000000000000
000000000000000000000000000000000002020000000000000000000000000000000000000
000000000000000000000000000000000002020000000000000000000000000000000000000
000000000000000000000000000000000002020000000000000000000000000000000000000
000000000000000000000000000000000002520000000000000000000000000000000000000
000000000000000000000000000000001111111111000000000000000000000000000000000
000000000000000000000000000000009962929999000000000000000000000000000000000
000000000000000000000000000000009792929979000000000000000000000000000000000
000000000000011111111000000000009992929999000000000001111111100000000000000
000000000000000000000000000000009792929979000000000000000000000000000000000
000000000000000000000000000000009999999999000000000000000000000000000000000
000000000000000000000000000001111111111111111000000000000000000000000000000
111111110000000000000000000000000200000002000000000000000000000000111111111
000000000000000000000000000000000000000000000000000000000000000000000000000
000000000000000000000000000000000000000000000000000000000000000000000000000
000000000000000000000000000000000000000000000000000000000000000000000000000
000000000000001111000000000000000000000000000000000000001111000000000000000
000000000000000000000000000000000000000000000000000000000000000000000000000
000000000000000000000000000000000000000000000000000000000000000000000000000
000000000000000000000000000000000000000000000000000000000000000000000000000
000000000000000000000000111100000000000000000011110000000000000000000000000
000000000000000000000000000000000000000000000000000000000000000000000000000
000000000000000000000000000000000000000000000000000000000000000000000000000
000000000000000000000000000000000111111110000000000000000000000000000000000
000000000000000000000000000000000000200000000000000000000000000000000000000
000000000000000000000000000000000000200000000000000000000000000000000000000
000000000000000000000011111000000000200000000001111100000000000000000000000
000000000000000000000000000000000030200000000000000000000000000000000000000
000000000000000000000000000000000000200000000000000000000000000000000000000
000000000000111110000000000000000000200000000000000000000111110000000000000
000000000000000000000000000000000000200000000000000000000000000000000000000
000000000000000000000000000000000000200000000000000000000000000000000000000
111111110000000000000000000000000000200000000000000000000000000000111111111
002000000000000000000000000000000000200000000000000000000000000000000000200
002000000000000000000000000000000000230000000000000000000000000000000000200
002000000000000000000000000000000000200000000000000000000000000000000000200
302000000111111110000000000000000000200000000000000000000111111110000000200
002000000200000000000000000000000000200000000000000000000000000020000000230
000000000200000000000000000000000000200000000000000000000000000020000000200
000000000200000000011111111000000000000000000001111111100000000020000000000
000000000000000000000000000000000000000000000000000000000000000000000000000
000000000000000000000000000000000000300000000000000000000000000000000000000
000000000000000000000000000000000000000000000000000000000000000000000000000
000000000000000000000000000000111111111111110000000000000000000000000000000
000000000000000000000000000000000000200000000000000000000000000000000000000
000000000000000000000000000000000000200000000000000000000000000000000000000
000000000000000000011111110000000000200000000000111111100000000000000000000
000000000000000000000000000000000000200000000000000000000000000000000000000
000000000000000000000000000000000000000000000000000000000000000000000000000
000000001111111000000000000000000000000000000000000000000000111111100000000
000000000000000000000000000000000000000000000000000000000000000000000000000
000000000000000000000000000000000000000000000000000000000000000000000000000
000000000000000000000000000000000000000000000000000000000000000000000000000
111111111111000000000000000000000000000000000000000000000000000011111111111
000000000001111111111100000000000000000000000000000001111111111110000000000
000000000000000020000111111111000000000000000111111111000020000000000000000
000000000000000020000000000000000000000000000000000000000020000000000000000
000000000000000020000000000000000000300000000000000000000020000000000000000
000000000000000020000000000000000000000000000000000000000020000000000000000
000000000000000000000000000000000000000000000000000000000000000000000000000
000000000000000000000000000000001111111111000000000000000000000000000000000
000000000000000000000000111111111000000001111111110000000000000000000000000
000000000000000011111111100000000000000000000000011111111100000000000000000
030000001111111110000000000000000000000000000000000000000111111111000000030
000000000000000000000000000000000000000000000000000000000000000000000000000
000000000000000000000000000000000000000000000000000000000000000000000000000
000000000000000000000000000000000000000000000000000000000000000000000000000
111111111000000000000000000000000000000000000000000000000000000000111111111
000000001111111100000000000000000000000000000000000000000001111111100000000
000000000000000111111110000000000000000000000000000011111111000000000000000
000000000000000000000011111110000000000000001111111110000000000000000000000
000000000000000000000000000011111111111111111000000000000000000000000000000
000000000000000000000000000000000002220000000000000000000000000000000000000
000000000000000000000000000000000002220000000000000000000000000000000000000