000000000000000000000000000000000000202000000000000000000000000000000000000
000000000000000000000000000000000000202000000000000000000000000000000000000
000000000000000000000000000000000000202000000000000000000000000000000000000
000000000000000000000000000000000000202000000000000000000000000000000000000
000000000000000000000000000000000000202000000000000000000000000000000000000
000000000000000000000000000000000000202000000000000000000000000000000000000
000000000000000000000000000000000000202000000000000000000000000000000000000
000000000000000000000000000000000000202000000000000000000000000000000000000
000000000000000000000000000000000000252000000000000000000000000000000000000
000000000000000000000000000000011111111111110000000000000000000000000000000
000000000000000000000000000000099969292999990000000000000000000000000000000
000000000000000000000000000000099799292979990000000000000000000000000000000
000000000000000000000000000000099999292999990000000000000000000000000000000
000000000000000000000000000000099799292979990000000000000000000000000000000
000000000000000000000000000000099999999999990000000000000000000000000000000
000000000000000111111111111111111111111111111111111111111111000000000000000
000000000000000020000000200000000000000000000000002000000020000000000000000
000000000000000020000000200000000000000000000000002000000020000000000000000
000000000000000020000000200000000000000000000000002000000020000000000000000
000000000000000020000000200000000000000000000000002000000020000000000000000
000000000000000020000000200000000000000000000000002000000020000000000000000
000000000000000020000000200000000000000000000000002000000020000000000000000
000000000000000020000000200000000000000000000000002000000020000000000000000
000000000000000020000000200000000000000000000000002000000020000000000000000
000111111111111111100000200000000000000000000000002000001111111111111111000
000000000002000000000000000000000000000000000000000000000000000200000000000
030000000002000000000000000000000000000000000000000000000000000200000000030
000000000002000000000000000000000000030000000000000000000000000200000000000
000000000002000000000000000000000000000000000000000000000000000200000000000
000000000002000000000000001111111111111111111111100000000000000200000000000
000000000002000000000000000000000000000000000000000000000000000200000000000
111111111002000000000000000000000000000000000000000000000000000200111111111
000000001111111000000000000000000000030000000000000000000000111111100000000
000000000000001111111000000000000000000000000000000000111111100000000000000
000000000000000000000000000000001111111111100000000000000000000000000000000
000000000000000000000000000000000000000000000000000000000000000000000000000
000000000000000000000000000000000000000000000000000000000000000000000000000
000000000000000000000011111111100000000000001111111110000000000000000000000
000000000000000000000000020000000000000000000000020000000000000000000000000
000000000000000000000000020000000000000000000000020000000000000000000000000
000000000000000000000000020000000000000000000000020000000000000000000000000
000000000000000000000000020000000000000000000000020000000000000000000000000
000000000000000000000000020000000000000000000000020000000000000000000000000
000000000000000000000000020000000000000000000000020000000000000000000000000
000000000000000000111111111100000000000000000001111111111000000000000000000
000000000111111111100000000000000000000000000000000000001111111111000000000
001111111100000000000000000000000000000000000000000000000000000001111111100
000200000000000000000000000000000000000000000000000000000000000000000002000
000200000000000000000000000000000000000000000000000000000000000000000002000
000200000000000000000000000000000000000000000000000000000000000000000002000
000200000000000000000000000000000000000000000000000000000000000000000002000
000200000000000000000000000000000000000000000000000000000000000000000002000
111111111111111111111111111110000000000000000011111111111111111111111111111
000000000000000000000000002000000000000000000000200000000000000000000000000
000000000000000000000000002000000000000000000000200000000000000000000000000
000000000000000000000000002000000000000000000000200000000000000000000000000
000000000000000000000000002000000000000000000000200000000000000000000000000
000000000000000000000000002000000000000000000000200000000000000000000000000
000000000000000000000000002000000000030000000000200000000000000000000000000
000000000000000000000000002000000000000000000000200000000000000000000000000
000111111111111111000000111111111111111111111111111000000111111111111111000
000002000000000000000000000000000000000000000000000000000000000000000200000
000002000000000000000000000000000000000000000000000000000000000000000200000
000002000000000000000000000000000000000000000000000000000000000000000200000
000002000000000000000000000000000000000000000000000000000000000000000200000
003002000000000000000000000000000000000000000000000000000000000000000200300
000002000000000000000000000000000000000000000000000000000000000000000200000
111111111111111111111111111111111111111111111111111111111111111111111111111
000000000200000000000000000200000000000000000200000000000000000002000000000
000000000200000000000000000200000000000000000200000000000000000002000000000
000000000200000000000000000200000000000000000200000000000000000002000000000
000000000200000000000000000200000000000000000200000000000000000002000000000
000111111111111111111111111111111111111111111111111111111111111111111111000
000000000000000000000000000000000000200000000000000000000000000000000000000
000000000000000000000000000000000000200000000000000000000000000000000000000