000000000000000000000000000000000000000000000000000000000202000000000000000
000000000000000000000000000000000000000000000000000000000202000000000000000
000000000000000000000000000000000000000000000000000000000202000000000000000
000000000000000000000000000000000000000000000000000000000202000000000000000
000000000000000000000000000000000000000000000000000000000202005000000000000
000000000000000000000000000000000000000000000000000000000202111111110000000
000000000000000000000000000000000000000000000000000007796292999779000000000
000000000000000000000000000000000000000000000000000009999292999999000000000
000000000000000000000000000000000000000000000000000008999292999899000000000
000000000000000000000000000000000000000000000000000009979292997999000000000
000000000000000000000000000000000000000000000000000009999999999999000000000
000000000000000000000000200000000000000002000000001111111111111111111000000
000000000000000000000000200000000000000002000000000000000000000000000000000
000000000000000000000000200000000000000002000000000000000000000000000000000
111111000000000000000000200000000000000002000000000000000000000000000000000
002000000000000000000000200000000000000001111111000000000000000000000000000
002000000000000000000011111111111111111111000000000000000000001111111111111
002000000000111111111110000000000002000000000000000000000000000200000000000
002000000000000000000000000000000000000000000000000000000000000000000000000
002000000000000000000000000000000000000000000000000000000000000000000000000
002000000000000000000000002000000000000000000000000000000000000000000000000
000000000000000000000000002000000000000000000000002000000000000000000000000
000000000000000000000000002000000000000000000000002000000000000000000000000
111111111100000000000000002000000000000000000000002000000000000000000000000
300020000000000001111111111111100000000000000000002000000000000000001111111
000020000000000000020000000000111111111111111100002000000000000000000002000
000020000000000000020000000000000002000000000111111111111111100000000002000
000020000000000000020000000000000032000000000000000000000000000000000002000
000020000000000000000000000000000000000000000000000000000000000000000002000
000000000000000000000000000000000000000000000000000000000000000000000002000
000000011000000000000000000000000000000000000000000000000000000000000000000
000000000000000000000000000000000000000000000000000000000000000000000000000
000000000000000000000000000000000000000000000000000000000000000111111111111
000000000000000000000000000000000000000000000000000001111111111100000000200
000000000000000000000000000000000000000000001111111111000000000000000000200
000000000000000000000000000000000000000000000000000000000000000000000000200
000000000000000000000000000000000000000000000000000000000000000000000000200
000000000000000000000000000011111111110000000000000000000000000001111111111
000000000000000000000000000000000000000000000000000000000000000000200000000
000000000000000000000000000000000000000000000000000000000000000000200000000
000000000000000111111100000000000000000000000000000000000000000000200000000
000000000000000000000000000000000000000000000000000000000000000000200000000
000000000000000000000000000000000000000000000000000000000030000000200000000
000000000000000000000000000000000000000000000001110000000000000000000000000
000011111110000000000000000000000000011110000000000000000111000000000000000
000000020000000000000000000111100000000000000000000000000000000000000000000
000000020000000000000000000020000000000000000000000000000000000000000000000
000000020000000000000000000000000000000000002000000000000000000000000000000
000000000000000000000000000000000000000000002000000000000000000000000000000
000000000000000000000000000000000000000000002000000000000000000000000000000
111111111111111100000000000000000000000000002000000000000000000000000000000
000000000000000000000011111111111111111110002000000000000000000000000000000
000000000000000000000000000000020000000011111111111111000000000000000000000
000000000000000000000000000000020000000000000000000001111111111111110000000
000000000000000000000000000000000000000000000000000000000000000002000000000
000000000000000000000000000000000000000000000000000000000000000002000000300
000000000000000000200000000000000000000000000020000000000000000000000000000
000000000000000000200000000000000000000000000020000000000000000000000000000
000000000000000000200000000000000000000000000020000000000000000000000000000
000000000000000000200000000000000000000000000020000000000001111111111111111
000000000000000000200000000000000000000011111111111111111111000000000000000
000000000000000000200001111111111111111110000000000000000000000000000000000
300000111111111111111111000000000000000000000000000000000000000000000000000
000000002000000000000000000000000000000000000000000000000000000000000000000
000000002000000000000000000000000000000000000000000000000000000000000000000
000000002000000000000000000000002000000000000000000000000000000000000000000
000000000000000000000000000000002000000000000000000000000000000000000000000
000000000000000000000000000000002000000000000000000000000000000000000000000
111111111111110000000000000000002000000000000000000000000000000000000000000
000000000000011111111111111100002000000000000000000000000000000000000000000
000000000000000000000000000111111111111111000000000000000000000000000000000
000000000000000000000000000000000000000001111111111111110000000000000000000
000000000000000000000000000000000000000000000000000000011111111111111110000
000000000000000000000000000000000000000000000000000000000000000000200000000
000000000000000000000000000000000000000000000000000000000000000000200000000